1111111111111
1P000000000C1
1000011111001
1000010000001
1000010111101
1000010000E01
1111111111111
