1111111111111
1P00000001001
1000011111001
1000010000001
1000000111111
1000010000EC1
1111111111111
