111111
1P0001
100001
111101
1E0001
111111
