11111\r
1P0C1\r
10001\r
1E001\r
11111\r
