11111
1P0X1
10001
1E0C1
11111
