11111
1P0C1
1P001
1E001
11111
