111111
1P1001
111001
111101
1E0001
111111
